EA ./resources/block1.xpm
F 220,100,0
NO ./resources/block2.xpm
C 225,30,0
WE ./resources/block3.xpm
S ./resources/block4.xpm
R 1920 1080
SO ./resources/block5.xpm
11111111
10000101
111a0001
11111N11
11111111