EA ./1.jpg
F 220,100,0
NO ./resources/block2.xpm
C 225,30,0
WE ./resources/block3.xpm
S ./resources/block4.xpm
R 1920 1080
SO ./resources/block5.xpm
1111111
1N00001
1000001
1000001
1111111