EA ./resources/block1.xpm
F 220,100,0
NO ./resources/block2.xpm
C 225,30,0
WE ./resources/block3.xpm
S ./resources/block4.xpm
R 800 600
SO ./resources/block5.xpm
1111111111111
110000000000011111111
10000000000000000001
1111111101111101111
100001000000000001
10000100N00100001
1110000000000001
   111111111111
