              NO     ./resources/block2.xpm
SO ./resources/block7.xpm   
        EA           ./resources/block1.xpm          
WE  ./resources/block6.xpm
F  220, 100,0
 R  1920  1080
  C  225,30 ,0
S     ./resources/block4.xpm 
1111111
1000001
1000001
1000001
1000001
100N001
1000001
1111111