R 1920 1080
EA ./resources/text2.xpm
NO ./resources/text4.xpm
WE ./resources/text6.xpm
S ./resources/Medved.xpm
SO ./resources/text3.xpm
F 15,150,30
C 55,30,150
11111111111111        1111
1000W000002001        1001
10000000000001        1001
11111111111001        1001
          1201        1001
          1001        1001
          1001        1001
          1001        1001
11111111111001        1001
10000000000201        1001
10000000000001        1001
10011111111111        1201
1001                  1001
1001                  1001
1001                  1001
10011111111111        1001
10000000000001        1001
10000000000001        1001
11111111111111        1111