R 800 600
EA ./resources/block6.xpm
NO ./resources/block6.xpm
WE ./resources/block6.xpm
S ./resources/block6.xpm
SO ./resources/block6.xpm
F 0,100,0
C 20,30,150
11111111111
10000111111
100W011111
100000000111
111111111111111
  1111111