R 800 600
EA ./resources/block6.xpm
NO ./resources/block6.xpm
WE ./resources/block6.xpm
S ./resources/block6.xpm
SO ./resources/block6.xpm
F 15,150,30
C 55,30,150
1111111
1000001
11
1000001
10S0001
1111111