R 800 600
1111111
10011
101    
101
10S11
1111111