R 1920 1080
EA ./resources/text3.xpm
NO ./resources/text2.xpm
WE ./resources/text6.xpm
S ./resources/Medved-2.xpm
SO ./resources/text4.xpm
F 100,180,160
C 150,150,222
11111111111111111111111111111111
12000000000000000000000000000021
10000000000000000000000000000001
10000000200000000000000000000001
10000000000000000000000000000001
10000000000000000000000000000001
10000000000000000N00000000000001
10000000000000000000000000000001
10000000000000000000000000000001
10020000000000000000000000020001
10000000000000000000000000000001
10000000000000200000000000200001
10000000000000000000000000000001
11111111111111111111111111111111