R 800 800
NO ./resources/block5.xpm
SO ./resources/block3.xpm
EA ./resources/block6.xpm
WE ./resources/block4.xpm
S ./resources/Medved-2.xpm
F 220,100,0
C 225,30,0
111111
120021
100N01
120021
111111