R 1920 1080
EA ./resources/text3.xpm
NO ./resources/text4.xpm
WE ./resources/text5.xpm
S ./resources/block6.xpm
SO ./resources/text6.xpm
F 15,150,30
C 55,30,150
1111111111111111111111111111
1020000000000200000000000001
1111111111111111111111111101
1000000000000000000000002101
1011111111111111111111110101
1010000000000000000002010101
1010111111111111111111012101
1010100000000000000001010101
10101011111111111111N1010101
1010101111111111111111010101
1010100000000000000000010101
1010111111111111111111110101
1010000000000000000000000101
1011111111111111111111111101
1000000000000000000000000001
1111111111111111111111111111
