R 1920 1080
EA ./resources/text1.xpm
NO ./resources/text2.xpm
WE ./resources/text3.xpm
S ./resources/text4.xpm
SO ./resources/text5.xpm
F 15,150,30
C 55,30,150
11111111111111        1111
1000W000000001        1001
10000000000001        1001
11111111111001        1001
          1001        1001
          1001        1001
          1001        1001
          1001        1001
11111111111001        1001
10000000000001        1001
10000000000001        1001
10010000000001        1001
1001                  1001
1001                  1001
1001                  1001
10011111111111        1001
10000000000001        1001
10000000000001        1001
11111111111111        1111