R 800 600
EA ./resources/text1.xpm
NO ./resources/text1.xpm
WE ./resources/text1.xpm
S ./resources/text1.xpm
SO ./resources/text1.xpm
F 15,150,30
C 55,30,150
1111111
10011
101    
101
1N011
1111111