R 1920 1080
EA ./resources/block6.xpm
NO ./resources/block6.xpm
WE ./resources/block6.xpm
S ./resources/block6.xpm
SO ./resources/block6.xpm
F 100,180,160
C 150,150,222
11111111111111111111111111111111
10000000000000000000000000000001
10000000000000000000000000000001
10000000000000000000000000000001
10000000000000000000000000000001
10000000000000000000000000000001
10000000000000000N00000000000001
10000000000000000000000000000001
10000000000000000000000000000001
10000000000000000000000000000001
10000000000000000000000000000001
10000000000000000000000000000001
10000000000000000000000000000001
11111111111111111111111111111111